⣿⣿⣿⣿⣿⣿⣿⣿⣿⣿⡿⠿⠛⠛⠛⠛⠛⠛⠿⢿⣿⣿⣿⣿⣿⣿⣿⣿⣿⣿ 
⣿⣿⣿⣿⣿⣿⣿⠛⠉⠀⠀⠀⠀⠀⠀⠀⠀⠀⠀⠀⠀⠉⠛⣿⣿⣿⣿⣿⣿⣿ 
⣿⣿⣿⣿⠿⠃⠀⠀⠀⢀⣀⣀⡀⠀⠀⠀⠀⠀⠀⠀⠀⠀⠀⠀⠘⠿⣿⣿⣿⣿ 
⣿⣿⣿⠛⢀⣴⡞⣠⣾⣿⣿⣿⣷⠀⠀⢰⣷⣦⣶⣄⠀⠀⠀⠀⠀⠀⠛⣿⣿⣿ 
⣿⣿⠃⣠⣿⣿⣿⣿⣿⣿⣿⣿⣧⡄⠁⣸⣿⡟⢿⣿⣶⣶⣄⠀⠙⠀⠀⠘⣿⣿ 
⣿⡏⢰⣿⣿⣿⣿⣿⣿⣿⠿⣿⣿⣷⣾⢿⡷⠃⢹⣿⣿⣿⢿⣧⣴⣤⡀⠀⢹⣿ 
⣿⠀⢸⣿⣿⣿⣿⣿⣿⣿⣤⣿⣿⣿⣷⣦⠀⠀⠀⠈⠙⣿⠀⠈⢿⣿⠃⠀⠀⣿ 
⣿⠀⢸⣿⣿⣿⣿⣿⣿⣿⣿⣿⣿⣟⡁⣀⠀⠀⠀⠀⠀⠀⢰⣆⠈⣹⢧⡆⠀⣿ 
⣿⠀⢸⣿⣿⣿⣿⣿⣿⣿⣿⣿⣿⣿⣷⠄⠀⠀⠀⠀⠀⠀⠈⠉⠋⠉⠈⡇⠀⣿ 
⣿⣇⠈⣿⣿⣿⣿⣿⣿⣿⣿⣿⣿⣿⣿⡆⠀⠀⠀⠀⠀⠀⠀⠀⠀⢀⣰⠃⣸⣿ 
⣿⣿⡄⠘⣿⡿⠿⠿⣿⣿⣿⣿⣿⠛⠋⠀⠀⠀⠀⠀⠀⠀⠀⠀⣠⣾⠏⢠⣿⣿ 
⣿⣿⣿⣤⠈⠻⣶⣷⣤⣿⣿⡟⠋⠀⠀⠀⠀⠀⠀⠀⠀⠀⠀⢰⡿⠃⣤⣿⣿⣿ 
⣿⣿⣿⣿⣶⡄⠙⠻⣿⣿⣿⣿⣶⣤⡀⠀⠀⠀⠀⠀⠀⣀⠄⠋⢠⣶⣿⣿⣿⣿ 
⣿⣿⣿⣿⣿⣿⣿⣤⣀⠙⠛⠿⠯⠤⠀⠀⠀⠀⠀⠀⠀⣀⣤⣿⣿⣿⣿⣿⣿⣿ 
⣿⣿⣿⣿⣿⣿⣿⣿⣿⣿⣷⣶⣤⣤⣤⣤⣤⣤⣶⣾⣿⣿⣿⣿⣿⣿⣿⣿⣿⣿